{
    "name": "ステージ 6-2",
    "stage_id": "tutorial_19",
    "info" : "相手にブロックを置いてみよう２",
    "level" : 5,
    "mode" : "puthot",
    "get_hart_value" : 0,
    "block_limit" : 15,
    "load_workspace" : "07.xml",
    "map_size_x": 15,
    "map_size_y": 17,
    "map_data":[[0,0,0,0,0,0,0,0,0,0,0,0,0,0,0],
                [0,0,0,0,0,0,0,0,0,0,0,0,0,0,0],
                [0,0,0,0,0,0,0,0,0,0,0,0,0,0,0],
                [0,0,0,0,0,0,0,0,0,0,0,0,0,0,0],
                [0,0,0,0,0,0,0,0,0,0,0,0,0,0,0],
                [0,0,0,0,0,0,1,1,1,0,0,0,0,0,0],
                [0,0,0,0,1,1,0,0,0,1,1,0,0,0,0],
                [0,0,0,0,1,0,1,1,1,0,1,0,0,0,0],
                [0,0,0,0,1,3,1,0,1,4,1,0,0,0,0],
                [0,0,0,0,1,0,0,1,0,0,1,0,0,0,0],
                [0,0,0,0,0,1,1,0,1,1,0,0,0,0,0],
                [0,0,0,0,0,0,0,1,0,0,0,0,0,0,0],
                [0,0,0,0,0,0,0,0,0,0,0,0,0,0,0],
                [0,0,0,0,0,0,0,0,0,0,0,0,0,0,0],
                [0,0,0,0,0,0,0,0,0,0,0,0,0,0,0],
                [0,0,0,0,0,0,0,0,0,0,0,0,0,0,0],
                [0,0,0,0,0,0,0,0,0,0,0,0,0,0,0]],
    "cool_x": 5,
    "cool_y": 8,
    "hot_x": 9,
    "hot_y": 8,
    "cpu": {
        "level":1
    },
    "turn":100
}