{
    "name": "ステージ 7-2",
    "stage_id": "tutorial_21",
    "info" : "関数を使ってみよう",
    "level" : 7,
    "mode" : "gethart",
    "get_hart_value" : 10,
    "block_limit" : 99,
    "load_workspace" : "12.xml",
    "map_size_x": 15,
    "map_size_y": 17,
    "map_data":[[0,0,0,0,0,0,0,0,0,0,0,0,0,0,0],
                [0,0,0,0,0,0,0,0,0,0,0,0,0,0,0],
                [0,2,0,2,0,2,0,2,0,2,0,2,0,2,0],
                [0,0,0,0,0,0,0,0,0,0,0,0,0,0,0],
                [0,2,0,2,0,2,0,2,0,2,0,2,0,2,0],
                [0,0,0,0,0,0,0,0,0,0,0,0,0,0,0],
                [0,2,0,2,0,2,0,2,0,2,0,2,0,2,0],
                [0,0,0,0,0,0,0,0,0,0,0,0,0,0,0],
                [0,2,0,2,0,2,0,3,0,2,0,2,0,2,0],
                [0,0,0,0,0,0,0,0,0,0,0,0,0,0,0],
                [0,2,0,2,0,2,0,2,0,2,0,2,0,2,0],
                [0,0,0,0,0,0,0,0,0,0,0,0,0,0,0],
                [0,2,0,2,0,2,0,2,0,2,0,2,0,2,0],
                [0,0,0,0,0,0,0,0,0,0,0,0,0,0,0],
                [0,2,0,2,0,2,0,2,0,2,0,2,0,2,0],
                [0,0,0,0,0,0,0,0,0,0,0,0,0,0,0],
                [0,0,0,0,0,0,0,0,0,0,0,0,0,0,0]],
    "cool_x": 7,
    "cool_y": 8,
    "turn":100
}