{
    "name": "ステージ 4-4",
    "stage_id": "tutorial_153",
    "info" : "自滅を回避しよう",
    "level" : 6,
    "mode" : "gethart",
    "get_hart_value" : 8,
    "block_limit" : 25,
    "load_workspace" : "051.xml",
    "map_size_x": 15,
    "map_size_y": 17,
    "map_data":[[0,0,0,0,0,0,0,0,0,0,0,0,0,0,0],
                [0,0,0,0,0,0,0,0,0,0,0,0,0,0,0],
                [0,0,0,0,0,0,0,0,0,0,2,0,0,0,0],
                [0,0,0,0,0,0,0,0,0,0,2,1,0,0,0],
                [0,0,0,0,0,0,0,0,1,1,2,0,0,0,0],
                [0,0,0,0,0,0,1,1,2,1,2,1,0,0,0],
                [0,0,0,0,0,1,2,1,2,1,0,0,0,0,0],
                [0,0,0,0,1,2,1,0,0,0,0,0,0,0,0],
                [0,0,0,0,2,0,0,0,0,0,0,0,0,0,0],
                [0,0,1,1,0,0,0,0,0,0,0,0,0,0,0],
                [0,0,3,0,0,0,0,0,0,0,0,0,0,0,0],
                [0,0,0,0,0,0,0,0,0,0,0,0,0,0,0],
                [0,0,0,0,0,0,0,0,0,0,0,0,0,0,0],
                [0,0,0,0,0,0,0,0,0,0,0,0,0,0,0],
                [0,0,0,0,0,0,0,0,0,0,0,0,0,0,0],
                [0,0,0,0,0,0,0,0,0,0,0,0,0,0,0],
                [0,0,0,0,0,0,0,0,0,0,0,0,0,0,0]],
    "cool_x": 2,
    "cool_y": 10,
    "turn":18
}