{
    "name": "ステージ 5-3",
    "stage_id": "tutorial_171",
    "info" : "たくさんアイテムをゲットしよう",
    "level" : 6,
    "mode" : "gethart",
    "get_hart_value" : 50,
    "block_limit" : 35,
    "load_workspace" : "09.xml",
    "map_size_x": 15,
    "map_size_y": 17,
    "map_data":[[0,0,0,0,0,0,0,0,0,0,0,0,0,0,0],
                [0,0,0,0,0,0,0,0,0,0,0,0,0,0,0],
                [0,0,0,0,0,0,0,0,0,0,0,0,0,0,0],
                [0,2,2,2,2,2,2,2,2,2,2,2,0,0,0],
                [0,2,0,0,0,0,0,0,0,0,0,2,0,0,0],
                [0,2,0,2,2,2,2,2,2,2,0,2,0,0,0],
                [0,2,0,2,0,0,0,0,0,2,0,2,0,0,0],
                [0,2,0,2,0,2,2,2,0,2,0,2,0,0,0],
                [0,2,0,2,0,2,0,3,0,2,0,2,0,0,0],
                [0,2,0,2,0,2,0,0,0,2,0,2,0,0,0],
                [0,2,0,2,0,2,2,2,2,2,0,2,0,0,0],
                [0,2,0,2,0,0,0,0,0,0,0,2,0,0,0],
                [0,2,0,2,2,2,2,2,2,2,2,2,0,0,0],
                [0,2,0,0,0,0,0,0,0,0,0,0,0,0,0],
                [0,2,2,2,2,2,2,2,2,2,2,2,4,0,0],
                [0,0,0,0,0,0,0,0,0,0,0,0,0,0,0],
                [0,0,0,0,0,0,0,0,0,0,0,0,0,0,0]],
    "cool_x": 7,
    "cool_y": 8,
    "hot_x": 12,
    "hot_y": 14,
    "cpu": {
        "level":1
    },
    "turn":100
}